NO ./textures/bluestone.png
SO ./textures/colorstone.png
WE ./textures/redbrick.png
EA ./textures/greystone.png
F 220,100,0
C 225,30,0

1111111111111111
1000000000110001
1111011111111101
1111011111111101
1100000011010101
1000000000000001
1000000000W00001
1100000111010101
11110111 1110101
11111111 1111111