NO ./textures/bluestone.png
SO ./textures/colorstone.png
WE ./textures/redbrick.png
EA ./textures/greystone.png
F 220,100,0
C 225,30,0

111111111111111111111
100000000011000001110111111111111
11110111111111011100000010001
11110111111111011101010010001
11000000110101011100000010001
10000000000000000000000010001
1000000000W000000001010010001
1100000111010101111101111000111
11110111 1110101 101111010001
11111111 1111111 111111111111