NO ./textures/bluestone.png
SO ./textures/colorstone.png
WE ./textures/redbrick.png
EA ./textures/greystone.png
F 220,100,0
C 225,30,0
        1111111111111111111111111
        1000000000110000000000001
        1011000001110000000000001
        100100000000000000000W001
        1111111111111111111111111