NO ./textures/bluestone.png
SO ./textures/colorstone.png
WE ./textures/purplestone.png
EA ./textures/greystone.png
F 128,128,128
C 150,30,0
 11
1W01
 11
1111111111111111111111111                   