NO ./textures/bluestone.png
SO ./textures/colorstone.png
WE ./textures/purplestone.png
EA ./textures/greystone.png
F 128,128,128
C 150,30,0

1111
1W11
1001
11101
1111