NO ./textures/bluestone.png
SO ./textures/colorstone.png
WE ./textures/purplestone.png
EA ./textures/greystone.png
F 128,128,128
C 150,30,0
        1111111111111111111111111
        1000000000110000000000001
        1001000001100000000000001       
        100100000000000000000W001
        1111111111111111111111111