1111111111
1110000001
1000111111
1110000001
1111111111